Mineau Thach Tests IA



#######
#     #
#. @  #
#######
0;

#######
#     #
#  @ $#
#######
1;

#######
##    #
#.#@ $#
#######
2;

#######
#    ##
#. @#$#
#######
3;

#######
#  #  #
#.#@#$#
#######
3.5;

############
#          #
#@  $  # . #
#      #   #
############
4;

############
#          #
#@  .  # $ #
#      #   #
############
5;

############
#          #
#@  $  # . #
#      #   #
############
6;

##########################
#      #### ### ##   # . #
#      #     #  # #  #   #
#      ###   #  #  # #   #
#@  $  #     #  #   ##   #
#      #    ### #   ##   #
#                        #
#                        #
##########################
7;
